7
7
XXXXXXX
X X  XX
X X X  
X     X
XX XX X
X  X  X
X XXXXX